Name: 09
AuthorName: Hiroyuki Imabayashi
Difficulty: 3

..........#######
..........#..XXX#
......#####..XXX#
......#......X.X#
......#..##..XXX#
......##.##..XXX#
.....###.########
.....#.BBB.##
.#####..B.B.#####
##...#B.B...#...#
#@.B..B....B..B.#
######.BB.B.#####
.....#......#
.....########
